
SO ./1.xpm
WE ./2.xpm
EA ./3.xpm
NO ./4.xpm


  F 255, 255,255

  C 200,  100, 32 


       1111111111111111111111111
       1000000000110100000000001
        10110000011100000000S0001
        1001000000000000000000001 
111111110011000001110000001000001
10000000001100000111011111111111
1110111111111011100000010001  
11110111111111011101010010001
11000000110101011100000010001
111100000000000011000000100011
   1000000000000100110101001001
1111000111010101 111 111100111
11110111 1110101 101111010001
11111111 1111111 1111111 1111