11111111111111111111111111111111111111111111111111111
10000000001100000100001000010000000001000010000100001
10110000011100000100001000000000000001000010000100001
10010000000000000100001000000000000001000010000100001
11111111101100000100001000010000000001000010000100001
11111111101100000100001000010000000001000010000100001
1100000000110N000100000000000000000000000000000000001
1100000000110N000100000000000000000000000000000000001
1100000000110N000100000000000000000000000000000000001
1100000000110N000100000000000000000000000000000000001
1100000000110N000100000000000000000000000000000000001
1100000000110N000100000000000000000000000000000000001
1100000000110N000100000000000000000000000000000000001
1100000000110N000100000000000000000000000000000000001
1100000000110N000100000000000000000000000000000000001
1100000000110N000100000000000000000000000000000000001
1100000000110N000100000000000000000000000000000000001
1100000000110N000100000000000000000000000000000000001
1100000000110N000100000000000000000000000000000000001
1100000000110N000100000000000000000000000000000000001
1100000000110N000100000000000000000000000000000000001
1100000000110N000100000000000000000000000000000000001
1100000000110N000100000000000000000000000000000000001
1100000000110N000100000000000000000000000000000000001
1100000000110N000100000000000000000000000000000000001
1100000000110N000100000000000000000000000000000000001
1100000000110N000100000000000000000000000000000000001
11111111111111111111111111111111111111111111111111111