
SO ./1.xpm
WE ./2.xpm
EA ./3.xpm
NO ./4.xpm


  F 255, 255,255
  
  C 200,  100, 32 

111111111111111
100000001100001
111101111111011
111101111111011
110000000101011
10000000N000001
111111111111111