
SO ./1.xpm
WE ./1.xpm
EA ./1.xpm
NO ./1.xpm


  F 202, 30,3
  
  C 200,  100, 32 


        1111111111111111111111111
        1000000000110100000000001
        10110000011100000000S0001
        1001000000000000000000001
111111110011000001110000001000001
100000000011000001110111111111111
11110111111111011100000010001  
11110111111111011101010010001
11000000110101011100000010001
111100000000000011000000100011
   1000000000000100110101001001
1111000111010101 1110111100111
11110111 1110101 101111010001
11111111 1111111 1111111 1111